**************
*@          @*
*            *
*            *
*            *
*            *
*            *
*     +      *
*            *
*            *
*            *
*            *
*@          @*
**************
